{
    "name": "world_test",
    "texture": "texture_pack",
    "width": 28,
    "height": 38,
    "tileWidth": 16,
    "tileHeight": 16,
    "back": [23,57,57,57,57,57,57,57,57,57,57,57,57,57,57,57,57,57,57,57,57,57,57,57,57,57,57,23,
    23,43,43,43,65,43,43,43,11,12,12,12,12,12,12,12,12,12,12,12,12,12,12,12,12,29,30,23,
    23,43,43,43,43,43,43,43,43,11,12,12,12,12,12,12,12,12,12,12,12,12,12,12,12,63,64,23,
    23,43,43,43,43,43,43,43,43,43,11,12,12,12,12,12,12,12,12,12,12,12,12,12,12,12,12,23,
    23,43,43,43,43,43,43,43,43,43,43,46,12,12,12,12,12,12,12,12,12,12,12,12,12,12,12,23,
    23,43,43,43,43,43,43,43,43,43,43,43,11,12,12,12,12,12,12,12,12,12,12,12,12,12,12,23,
    23,43,43,43,7,8,43,43,21,22,43,43,43,46,12,12,12,12,12,12,12,12,12,12,12,12,12,23,
    23,43,43,43,41,42,43,43,55,56,43,43,43,43,11,12,12,12,12,12,12,12,12,12,12,12,12,23,
    23,43,43,43,43,43,43,43,43,43,43,43,43,43,43,46,12,12,12,12,12,12,12,12,12,12,12,23,
    23,4,3,4,3,4,3,4,3,4,3,4,3,4,3,4,3,4,3,4,3,4,3,4,3,4,3,23,
    23,43,43,43,65,43,43,43,65,43,43,43,65,43,43,43,65,43,43,43,65,43,43,43,65,43,43,23,
    23,43,43,43,43,43,43,43,43,43,43,43,43,43,43,43,43,43,43,43,43,43,43,43,43,43,43,23,
    23,43,43,43,43,43,43,43,43,43,43,43,43,43,43,43,43,43,43,43,43,43,43,43,43,43,43,23,
    23,43,43,43,7,8,43,43,19,20,43,43,43,7,8,43,43,43,43,43,43,43,7,8,43,43,43,23,
    23,43,43,43,41,42,43,43,53,54,43,43,43,41,42,43,43,43,43,43,43,43,41,42,43,43,43,23,
    23,43,43,43,43,43,43,43,43,43,43,43,43,43,43,43,43,43,43,43,43,43,43,43,43,43,43,23,
    23,4,3,4,3,4,3,4,3,4,3,4,3,4,3,4,3,4,3,4,3,4,3,4,3,4,3,23,
    23,43,43,43,65,43,43,43,65,43,43,43,65,43,43,43,65,43,43,43,65,43,43,43,65,43,43,23,
    23,9,9,9,9,9,9,9,9,9,9,9,9,9,9,9,9,9,9,9,9,9,9,9,9,9,9,23,
    23,44,44,44,44,44,44,44,44,44,44,44,44,44,44,44,44,44,44,44,44,44,44,44,44,44,44,23,
    23,44,44,44,7,8,44,44,17,18,44,44,44,44,44,44,7,8,7,8,7,8,7,8,44,44,44,23,
    23,44,44,44,41,42,44,44,51,52,44,44,44,44,44,44,41,42,41,42,41,42,41,42,44,44,44,23,
    23,44,44,44,44,44,44,44,44,44,44,44,44,44,44,44,44,44,44,44,44,44,44,44,44,44,44,23,
    23,4,3,4,3,4,3,4,3,4,3,4,3,4,3,4,3,4,3,4,3,4,3,4,3,4,3,23,
    23,44,44,44,65,44,44,44,65,44,44,44,65,44,44,44,65,44,44,44,65,44,44,44,65,44,44,23,
    23,44,44,44,44,44,44,44,44,44,44,44,44,44,44,44,44,44,44,44,44,44,44,44,44,44,44,23,
    23,44,44,44,44,44,44,44,44,44,44,44,44,44,44,44,44,44,44,66,44,44,44,44,44,44,44,23,
    23,44,44,44,7,8,44,44,15,16,44,44,44,7,8,44,44,1,1,44,44,44,7,8,44,44,44,23,
    23,44,44,44,41,42,44,44,49,50,44,44,44,41,42,44,1,1,1,44,44,44,41,42,44,44,44,23,
    23,44,44,44,44,44,44,44,44,44,44,44,44,44,44,44,44,44,44,44,44,44,44,44,44,44,44,23,
    23,4,3,4,3,4,3,4,3,4,3,4,3,4,3,4,3,4,3,4,3,4,3,4,3,4,3,23,
    23,44,44,44,65,44,44,44,65,44,44,44,65,44,44,44,65,44,44,44,65,44,44,44,65,44,44,23,
    23,9,9,9,9,9,9,9,9,9,9,9,9,9,9,9,9,9,9,9,9,9,9,9,9,9,9,23,
    23,44,44,44,44,44,44,44,44,44,44,44,44,44,44,44,44,44,44,44,44,44,44,44,44,44,44,23,
    23,44,44,44,7,8,44,44,13,14,44,44,44,7,8,44,44,44,31,32,44,44,7,8,44,44,44,23,
    23,44,44,44,41,42,44,44,47,48,44,44,44,41,42,44,44,44,33,34,44,44,41,42,44,44,44,23,
    23,44,44,44,44,44,44,44,44,44,44,44,44,44,44,44,44,44,67,68,44,44,44,44,44,44,44,23,
    4,3,4,3,4,3,4,3,4,3,4,3,4,3,4,3,4,3,4,3,4,3,4,3,4,3,4,3],
    "front": [0,0,0,0,0,0,0,0,0,0,0,0,0,0,0,0,0,0,0,0,0,0,0,0,0,0,0,0,
    0,0,0,0,0,0,0,0,0,0,0,0,0,0,0,0,0,0,0,0,0,0,0,0,0,0,0,0,
    0,0,0,0,0,0,0,0,0,0,0,0,0,0,0,0,0,0,0,0,0,0,0,0,0,0,0,0,
    0,0,0,0,0,0,0,0,0,0,0,0,0,0,0,0,0,0,0,0,0,0,0,0,0,0,0,0,
    0,0,0,0,0,0,0,0,0,0,0,0,0,0,0,0,0,0,0,0,0,0,0,0,0,0,0,0,
    0,0,0,0,0,0,0,0,0,0,0,0,0,0,0,0,0,0,0,0,0,0,0,0,0,0,0,0,
    0,0,0,0,0,0,0,0,0,0,0,0,0,0,0,0,0,0,0,0,0,0,0,0,0,0,0,0,
    0,0,0,0,0,0,0,0,0,0,0,0,0,0,0,0,0,0,0,0,0,0,0,0,0,0,0,0,
    0,0,0,0,0,0,0,0,0,0,0,0,0,0,0,0,0,0,0,0,0,0,0,0,0,0,0,0,
    0,0,0,0,0,0,0,0,0,0,0,0,0,0,0,0,0,0,0,0,0,0,0,0,0,0,0,0,
    0,0,0,0,0,0,0,0,0,0,0,0,0,0,0,0,0,0,0,0,0,0,0,0,0,0,0,0,
    0,0,0,0,0,0,0,0,0,0,0,0,0,0,0,0,0,0,0,0,0,0,0,0,0,0,0,0,
    0,0,0,0,0,0,0,0,0,0,0,0,0,0,0,0,0,0,0,0,0,0,0,0,0,0,0,0,
    0,0,0,0,0,0,0,0,0,0,0,0,0,0,0,0,0,0,0,0,0,0,0,0,0,0,0,0,
    0,0,0,0,0,0,0,0,0,0,0,0,0,0,0,0,0,0,0,0,0,0,0,0,0,0,0,0,
    0,0,0,0,0,0,0,0,0,0,0,0,0,0,0,0,0,0,0,0,0,0,0,0,0,0,0,0,
    0,0,0,0,0,0,0,0,0,0,0,0,0,0,0,0,0,0,0,0,0,0,0,0,0,0,0,0,
    0,0,0,0,0,0,0,0,0,0,0,0,0,0,0,0,0,0,0,0,0,0,0,0,0,0,0,0,
    0,0,0,0,0,0,0,0,0,0,0,0,0,0,0,0,0,0,0,0,0,0,0,0,0,0,0,0,
    0,0,0,0,0,0,0,0,0,0,0,0,0,0,0,0,0,0,0,0,0,0,0,0,0,0,0,0,
    0,0,0,0,0,0,0,0,0,0,0,0,0,0,0,0,0,0,0,0,0,0,0,0,0,0,0,0,
    0,0,0,0,0,0,0,0,0,0,0,0,0,0,0,0,0,0,0,0,0,0,0,0,0,0,0,0,
    0,0,0,0,0,0,0,0,0,0,0,0,0,0,0,0,0,0,0,0,0,0,0,0,0,0,0,0,
    0,0,0,0,0,0,0,0,0,0,0,0,0,0,0,0,0,0,0,0,0,0,0,0,0,0,0,0,
    0,0,0,0,0,0,0,0,0,0,0,0,0,0,0,0,0,0,0,0,0,0,0,0,0,0,0,0,
    0,0,0,0,0,0,0,0,0,0,0,0,0,0,0,0,0,0,0,0,0,0,0,0,0,0,0,0,
    0,0,0,0,0,0,0,0,0,0,0,0,0,0,0,0,0,0,0,0,0,0,0,0,0,0,0,0,
    0,0,0,0,0,0,0,0,0,0,0,0,0,0,0,0,0,0,0,0,0,0,0,0,0,0,0,0,
    0,0,0,0,0,0,0,0,0,0,0,0,0,0,0,0,0,0,0,0,0,0,0,0,0,0,0,0,
    0,0,0,0,0,0,0,0,0,0,0,0,0,0,0,0,0,0,0,0,0,0,0,0,0,0,0,0,
    0,0,0,0,0,0,0,0,0,0,0,0,0,0,0,0,0,0,0,0,0,0,0,0,0,0,0,0,
    0,0,0,0,0,0,0,0,0,0,0,0,0,0,0,0,0,0,0,0,0,0,0,0,0,0,0,0,
    0,0,0,0,0,0,0,0,0,0,0,0,0,0,0,0,0,0,0,0,0,0,0,0,0,0,0,0,
    0,0,0,0,0,0,0,0,0,0,0,0,0,0,0,0,0,0,0,0,0,0,0,0,0,0,0,0,
    0,0,0,0,0,0,0,0,0,0,0,0,0,0,0,0,0,0,0,0,0,0,0,0,0,0,0,0,
    0,0,0,0,0,0,0,0,0,0,0,0,0,0,0,0,0,0,0,0,0,0,0,0,0,0,0,0,
    0,0,0,0,0,0,0,0,0,0,0,0,0,0,0,0,0,0,0,0,0,0,0,0,0,0,0,0,
    0,0,0,0,0,0,0,0,0,0,0,0,0,0,0,0,0,0,0,0,0,0,0,0,0,0,0,0], 
    "tiles": [
        {
          "value": 3,
          "collision": "0x0100"
        },
        {
          "value": 4,
          "collision": "0x0100"
        },
        {
          "value": 23,
          "collision": "0x1111"
        },
        {
          "value": 57,
          "collision": "0x1111"
        }
    ]
}





